1111111111111
1001C00W000C1
1000010111001
100011E10P001
1111111111111